0000000000000000000000000000000000000000000000000000000000000000
0000000000000002222200000000000000022220000000000000000000000000
0000000000000000111000000000000000001100000000000000000000000000
0000000000000000000000000000000000000000000000000000000000000000
0000000000000000000011111000000000000000000000000000000000000002
0022111112222222222221122113331122222222221111111222222222222222
0001133311111111111111000033300000000000111333331110000000000110
0003333333333333333330000003000000000000000033333300000000000030
0000000000000000000000000000000000000000000003330000000000000030
0000000000000000000000000000000000000000000000000000000000000000